Ariel the Little Mermaid -> Ariel - The Little Mermaid (USA, Europe, Brazil) (En).zip
Ax Battler: A Legend of Golden Axe -> Ax Battler - A Legend of Golden Axe (USA, Europe, Brazil) (En).zip
Columns -> Columns (USA, Europe, Brazil) (En) (Rev 2).zip
Crystal Warriors -> Crystal Warriors (USA, Europe).zip
Defenders of Oasis -> Defenders of Oasis (USA, Europe).zip
Fantasy Zone Gear -> Fantasy Zone (USA, Brazil) (En).zip
Gunstar Heroes -> Gunstar Heroes (Japan).zip
Land of Illusion Starring Mickey Mouse -> Land of Illusion Starring Mickey Mouse (USA, Europe, Brazil) (En).zip
Mortal Kombat II -> Mortal Kombat II (World).zip
NBA Jam -> NBA Jam (USA) (Rev 1).zip
Nazo Puyo Arle no Roux -> Nazo Puyo - Arle no Roux (Japan).zip
Ninja Gaiden -> Ninja Gaiden (USA, Europe, Brazil) (En).zip
Ristar -> Ristar (World).zip
Shining Force Gaiden: Final Conflict -> Shining Force Gaiden - Final Conflict (Japan).zip
Shining Force: The Sword of Hajya -> Shining Force - The Sword of Hajya (USA).zip
Shinobi -> Shinobi (World) (Rev A).zip
Sonic Blast -> Sonic Blast (World).zip
Sonic Chaos -> Sonic Chaos (USA, Europe, Brazil) (En).zip
Sonic Drift 2 -> Sonic Drift 2 (World).zip
Sonic Triple Trouble -> Sonic The Hedgehog - Triple Trouble (USA, Europe, Brazil) (En).zip
Sonic the Hedgehog -> Sonic The Hedgehog (Japan, USA) (En).zip
Sonic the Hedgehog 2 -> Sonic The Hedgehog 2 (World).zip
Streets of Rage -> Streets of Rage (World).zip
Sylvan Tale -> Sylvan Tale (Japan).zip
Tails Adventure -> Tails Adventure (World) (En,Ja).zip
Tails' Skypatrol -> Tails no Skypatrol (Japan).zip
Tempo Jr. -> Tempo Jr. (World).zip
The G.G. Shinobi -> Shinobi (World) (Rev A).zip
Vampire: Master of Darkness -> Vampire - Master of Darkness (USA).zip
Wonder Boy III: The Dragon's Trap -> Wonder Boy - The Dragon's Trap (Europe).zip
World Series Baseball -> World Series Baseball '95 (USA).zip
